                    NO oui oui
SO oui
EA oui
WE oui

C 1,2,3
F oui




11111111111
10000000001
10000000001
10000000001 
10000000001
11111111111

